w,w,w,w,exit,w,w,w,w
w,,,,,,,,w
w,,,,,,,,w
w,e1_R,,,,,,,w
w,,,,,,,,w
w,,,,,,,e1_L,w
w,,,,,,,,w
w,,,,,,,,w
w,,,,,,,,w
w,e1_R,,,,,,,w
w,,,,,,,,w
w,w,w,w,enter,w,w,w,w